#####
#@$.#
#####
;
 ########
##      #
#   .   #
#   $   #
# .$@$. #
####$   #
   #.   #
   #   ##
   #####
;
#######
#  .. #
#     #
#   $ #
#  $@$#
####$ #
   #  #
   #..#
   ####
;
###########
#  .. # ..#
#     #   #
#   $ #   #
#  $@$#   #
#   $ #   #
#         #
#######   #
      #####
;
##########
#    #...#
#    #...#
# $$ #   #
# $@$#   #
# $$ #   #
#        #
#######  #
      ####